1111111111111111111111
100C0000CCC0000C011101
10P0000CC00000CC110011
1E0011000000C000111001
1111111111111111111111