111111111111
10010000CCC1
1P00C0000CC1
1EC010001101
111111111111