11111111111111111111111111111111111111111111111111111111111
10ECP100000000000000000000000000000000000000000000000000001
10000000000000000000000000000000000000000000000000000000001
10000000000000000000000000000000000000000000000000000000001
11111111111111111111111111111111111111111111111111111111111
11111111111111111111111111111111111111111111111111111111111