11111111111111111111111111111111111111111111111111111111111
10ECP1CCC00000000000000000000000000000000000000000000000001
1000000000000000000000000000CCCCCC0000000000000000000000001
10000000000000000000000000000000000000000000000000000000001
1111111111111CCCCCCCC11111111111111111111111111111111111111
11111111111111111111111111111111111111111111111111111111111